INSERT INTO TBVENDA                                                     00010002
(NUMVENDA,QTDVENDA,CODCLI,CODPROD)                                      00020000
VALUES                                                                  00030000
('000001',10,'0001','0001');                                            00040000
----------------------------------------------------------------------- 00050000
INSERT INTO TBVENDA                                                     00060002
(NUMVENDA,QTDVENDA,CODCLI,CODPROD)                                      00070000
VALUES                                                                  00080000
('000002',15,'0001','0002');                                            00090000
----------------------------------------------------------------------- 00100000
INSERT INTO TBVENDA                                                     00110002
(NUMVENDA,QTDVENDA,CODCLI,CODPROD)                                      00120000
VALUES                                                                  00130000
('000003',20,'0001','0003');                                            00140000
----------------------------------------------------------------------- 00150000
INSERT INTO TBVENDA                                                     00160002
(NUMVENDA,QTDVENDA,CODCLI,CODPROD)                                      00170000
VALUES                                                                  00180000
('000004',14,'0002','0001');                                            00190000
----------------------------------------------------------------------- 00200000
INSERT INTO TBVENDA                                                     00210002
(NUMVENDA,QTDVENDA,CODCLI,CODPROD)                                      00220000
VALUES                                                                  00230000
('000005',55,'0002','0006');                                            00240000
----------------------------------------------------------------------- 00250000
INSERT INTO TBVENDA                                                     00260002
(NUMVENDA,QTDVENDA,CODCLI,CODPROD)                                      00270000
VALUES                                                                  00280000
('000006',12,'0002','0001');                                            00290000
----------------------------------------------------------------------- 00300000
INSERT INTO TBVENDA                                                     00310002
(NUMVENDA,QTDVENDA,CODCLI,CODPROD)                                      00320000
VALUES                                                                  00330000
('000007',12,'0002','0007');                                            00340000
----------------------------------------------------------------------- 00350000
INSERT INTO TBVENDA                                                     00360002
(NUMVENDA,QTDVENDA,CODCLI,CODPROD)                                      00370000
VALUES                                                                  00380000
('000008',80,'0002','0008');                                            00390000
----------------------------------------------------------------------- 00400000
INSERT INTO TBVENDA                                                     00410002
(NUMVENDA,QTDVENDA,CODCLI,CODPROD)                                      00420000
VALUES                                                                  00430000
('000009',10,'0002','0005');                                            00440000
----------------------------------------------------------------------- 00450000
INSERT INTO TBVENDA                                                     00460002
(NUMVENDA,QTDVENDA,CODCLI,CODPROD)                                      00470000
VALUES                                                                  00480000
('000010',09,'0002','0009');                                            00490000
----------------------------------------------------------------------- 00500000
INSERT INTO TBVENDA                                                     00510002
(NUMVENDA,QTDVENDA,CODCLI,CODPROD)                                      00520000
VALUES                                                                  00530000
('000011',01,'0002','0010');                                            00540000
----------------------------------------------------------------------- 00550000
INSERT INTO TBVENDA                                                     00560002
(NUMVENDA,QTDVENDA,CODCLI,CODPROD)                                      00570000
VALUES                                                                  00580000
('000012',05,'0004','0001');                                            00590000
----------------------------------------------------------------------- 00600000
INSERT INTO TBVENDA                                                     00610002
(NUMVENDA,QTDVENDA,CODCLI,CODPROD)                                      00620000
VALUES                                                                  00630000
('000013',19,'0003','0006');                                            00640000
----------------------------------------------------------------------- 00650000
INSERT INTO TBVENDA                                                     00660002
(NUMVENDA,QTDVENDA,CODCLI,CODPROD)                                      00670000
VALUES                                                                  00680000
('000014',03,'0005','0002');                                            00690000
----------------------------------------------------------------------- 00700000
INSERT INTO TBVENDA                                                     00710002
(NUMVENDA,QTDVENDA,CODCLI,CODPROD)                                      00720000
VALUES                                                                  00730000
('000015',11,'0005','0009');                                            00740000
----------------------------------------------------------------------- 00750000
INSERT INTO TBVENDA                                                     00760002
(NUMVENDA,QTDVENDA,CODCLI,CODPROD)                                      00770000
VALUES                                                                  00780000
('000016',07,'0003','0001');                                            00790000
----------------------------------------------------------------------- 00800000
INSERT INTO TBVENDA                                                     00810002
(NUMVENDA,QTDVENDA,CODCLI,CODPROD)                                      00820000
VALUES                                                                  00830000
('000017',10,'0001','0001');                                            00840000
----------------------------------------------------------------------- 00850000
INSERT INTO TBVENDA                                                     00860002
(NUMVENDA,QTDVENDA,CODCLI,CODPROD)                                      00870000
VALUES                                                                  00880000
('000018',44,'0001','0003');                                            00890000
----------------------------------------------------------------------- 00900000
INSERT INTO TBVENDA                                                     00910002
(NUMVENDA,QTDVENDA,CODCLI,CODPROD)                                      00920000
VALUES                                                                  00930000
('000019',14,'0001','0010');                                            00940000
----------------------------------------------------------------------- 00950000
INSERT INTO TBVENDA                                                     00960002
(NUMVENDA,QTDVENDA,CODCLI,CODPROD)                                      00970000
VALUES                                                                  00980000
('000020',07,'0002','0006');                                            00990000
----------------------------------------------------------------------- 01000000
INSERT INTO TBVENDA                                                     01010002
(NUMVENDA,QTDVENDA,CODCLI,CODPROD)                                      01020000
VALUES                                                                  01030000
('000021',05,'0005','0001');                                            01040000
----------------------------------------------------------------------- 01050000
INSERT INTO TBVENDA                                                     01060002
(NUMVENDA,QTDVENDA,CODCLI,CODPROD)                                      01070000
VALUES                                                                  01080000
('000022',01,'0001','0008');                                            01090000
----------------------------------------------------------------------- 01100000
INSERT INTO TBVENDA                                                     01110002
(NUMVENDA,QTDVENDA,CODCLI,CODPROD)                                      01120000
VALUES                                                                  01130000
('000023',03,'0004','0007');                                            01140000
----------------------------------------------------------------------- 01150000
INSERT INTO TBVENDA                                                     01160002
(NUMVENDA,QTDVENDA,CODCLI,CODPROD)                                      01170000
VALUES                                                                  01180000
('000024',10,'0004','0007');                                            01190000
----------------------------------------------------------------------- 01200000
INSERT INTO TBVENDA                                                     01210002
(NUMVENDA,QTDVENDA,CODCLI,CODPROD)                                      01220000
VALUES                                                                  01230000
('000025',15,'0005','0001');                                            01240000
----------------------------------------------------------------------- 01250000
INSERT INTO TBVENDA                                                     01260002
(NUMVENDA,QTDVENDA,CODCLI,CODPROD)                                      01270000
VALUES                                                                  01280000
('000026',10,'0002','0001');                                            01290000
----------------------------------------------------------------------- 01300000
INSERT INTO TBVENDA                                                     01310002
(NUMVENDA,QTDVENDA,CODCLI,CODPROD)                                      01320000
VALUES                                                                  01330000
('000027',15,'0004','0005');                                            01340000
----------------------------------------------------------------------- 01350000
INSERT INTO TBVENDA                                                     01360002
(NUMVENDA,QTDVENDA,CODCLI,CODPROD)                                      01370000
VALUES                                                                  01380000
('000028',10,'0001','0005');                                            01390000
----------------------------------------------------------------------- 01400000
INSERT INTO TBVENDA                                                     01410002
(NUMVENDA,QTDVENDA,CODCLI,CODPROD)                                      01420000
VALUES                                                                  01430000
('000029',17,'0003','0008');                                            01440000
----------------------------------------------------------------------- 01450000
INSERT INTO TBVENDA                                                     01460002
(NUMVENDA,QTDVENDA,CODCLI,CODPROD)                                      01470000
VALUES                                                                  01480000
('000030',02,'0003','0003')                                             01490001
----------------------------------------------------------------------- 01500000
